SO      ./img/S.xpm
F                  110,110,110
EA          ./img/E.xpm
WE                              ./img/W.xpm

     C 41,41,41

          1111111111111111111111111111
       1111111022022002202220000000011111
      1111110001121100111111000000111111111    
   111111111100012100022222201100000000001111111   
11111111111111111211101111110111111000111111111111111
11022222222222200000000111112111100000222222222220001
 121111111111111110111111  121  1111211111111111111111
 1211111111111111100011111112111111121111
 121   1111102222200000000000000000001111
11211111111011111111112111111111111111
112111111110011      1211    1111111111111111111
112111110000011      100111111111111111
112111111000011111111110000000011111111111
 121111111000011111111100000000111
 1211111110000111111111000000001111
 12111111100002222222220000000011111
 121111111000011111111100000000111111
 1211111110000111111111000000001111111
 1002222220101111111100011111111111111111111111111111111111
 1111111111121111111111100000000000000000000000000000000001111
    1111111121111111   1111111111111111110000000000000000000111
    111111000011111          11111111111110000000000000000000111
    1000000000000E1                    1111111111111111100000011
    110000000000011                                  11111111111
    111000000000111
    111100000001111
    111110000011111
    111111000111111
    111111151111111
    111111111111111