NO  ./path_to_the_north_texture          

SO ./path_to_the_south_texture      

WE       ./path_to_the_west_texture

EA        ./path_to_the_east_texture

F 119,212,208

C 191,170,116

111111111111111
1100000100110011
10000001111001111
1111001111110001
100S000000010111
110001001000011111
10000010011000111
1111111111111111
