NO  ./path_to_the_north_texture          

SO ./path_to_the_south_texture      

WE       ./path_to_the_west_texture

EA        ./path_to_the_east_texture

F 220,100,0

C 225,30,0

        111111111111111111111111111
 111111111000110000110000000000001
10110000011100111000100111111111
100100000001000100001001
1111111110110N00011100001111111
100000000011000001110111111111111
11110111111111011100000010001
1111011 111111011101010010001
111111111111111 1111111111111
11000000110101011100000010001
10000000000000001100000010001
10000000000000001101010010001
110000011101010111110111100111
11110111 1110101 101111010001
11111111 1111111 111111111111
