NO  ./path_to_the_north_texture          

SO ./path_to_the_south_texture      

WE       ./path_to_the_west_texture

EA        ./path_to_the_east_texture

F 119,212,208

C 191,170,116

11111111111
11000001101
10000001111
11110011111
100S0001111
11000200111
10000010011
11111111111
