NO  ./path_to_the_north_texture          

SO ./path_to_the_south_texture      

WE       ./path_to_the_west_texture

EA        ./path_to_the_east_texture

F 11,11,11

C 99,99,99

11111111111
11000001101
10000001111
11100011111
100N0001111
11000000111
10000100011
11111111111
