NO  ./path_to_the_north_texture          

SO ./path_to_the_south_texture      

WE       ./path_to_the_west_texture

EA        ./path_to_the_east_texture

F 220,100,255

C 225,30,124

            111111111111111111111111
       11111110000000000000000000011111
      11111100000000000000000000001111111   1
111111111000000000000000000000000000111
   1011111111111111111111111111111111111111
  111111000000000000000111111111100000111111
   1111111111111111111111       11111111111
    1111111111111111111111111111110000111
      1111111100000000000N0000000111111
 1           1111111111111111111111111