NO           ./images/assets/Wall-000.xpm                      

SO ./images/assets/Wall-001.xpm         

WE       ./images/assets/Wall-002.xpm    

EA       ./images/assets/Wall-003.xpm   

F 119,212,208   

C 191,170,116      

     11111111111111
1     20000011
111111111001111        
10000011121001111
111100111211000111
110S000100010111
110001020000011111
11110011011000111
1111111111111111
