NO  ./path_to_the_north_texture          

SO ./path_to_the_south_texture      

WE       ./path_to_the_west_texture

EA        ./path_to_the_east_texture

F 161,152,180

C 136,178,16

            111111111111111111111111
       11111110000000000000000000011111
      11111100000000010101010000001111111   1
11111111100000000000000N00000000000111
   1011111111111111111111111111111111111111
  11111100000000000000011111111110000111111
   1111111111111111111111       11111111111
    1111111111111111111111111111110000111
      111111110000000000000000000111111
 1           1111111111111111111111111
 