             SO      ./img/S.xpm

        F                110,110,110
             EA          ./img/E.xpm    
WE                              ./img/W.xpm
   NO                     /img/N.xpm
     C 41,41,41

            111
            151
            101
            121
            121
            121
111111111111121111111111111
102222222222202222222222201
111111111111121111111111111
            121
            121
            121
            121
            121
            101
            1S1
            111