SO      ./img/S.xpm
F                  110,110,110
EA          ./img/E.xpm    
WE                              ./img/W.xpm

   NO                       ./img/N.xpm
     C 41,41,41

111111111111111111111111111
1E2222222222202222222222201
111111111111111111111111111