NO ./img/N.xpm
SO ./img/S.xpm
WE ./img/W.xpm
EA ./img/E.xpm    

F 110,110,110

C 41,41,41

     11111111111111
1    1020000011
111111111001111        
10000011121001111
111111111211000111
1100022220010111
110011111100011111
11111011011E02011
1111111111111111
