SO      ./img/S.xpm
F                  110,110,110
EA          ./img/E.xpm    
WE                              ./img/W.xpm

   NO                       ./img/N.xpm

F 110,110,110

C 41,41,41

11111111111111111111111111111111111111111111111111111111111111111111111111111111111111111111111111111111111111111111111111
1111110000000000000000000000000000000000000000000000000000000000000000000000000000000000000000000000000000000000000000W111
11111001111111121111111111211111211111111121111111111111112111111111111000000000001111111111111111111111121111111111111011
11111001000000001000000001001000011000000000000000000000000000000000000000000000010000000000000000000000000000000000000011
11000011110000010000000000100100002000000000111111111111111111111111111111111111100000000000111111211111000000000000000111
11000000001000100000000000010100001111111111100000000000000000000000000000000000000000000000000000000010000000000000001111
11111111121111111111111111110111111111111111121111111111111111111111112111111111111111111111111111121111211111111111121111
11111100121000000000000000000000000000000000121000000000000000000000000000000000000000000000000001000100001001000001000011
11111000121000000000000000000000000000000000121000000000000000000000000000000001210000000000000000010100001001000110000011
11111000121000000000000111111211100000000000121000000000000000000000000000000001210000000000000001001100010001001000000011
11000000121000000000001000000000010000000000121111111111111111111111111111100001210001111111111110001100100000100100000111
11000000121000000000010000000000001000000000000022222222222222222222222000100001210000000000000000001010010000001010001111
11111111121111111111111111111211111111111111111111111111111111111111111112111111211111101111111121111111111111111211111111
11111100121000000000000020000001000000000000000000000000000000000000000012100001210001001000000000000000000000000000000011
11111000121000000000000011111101000000000000011100000000000000000000000012100001210001011111111111111111111111211111111111
11111000121000000000000000000101000000000000010100000000000000000000000000000001210001000000000000000000000000000000000011
11000000121000000000000000000101111111111111100010000000000000000000000000000000000000100111111211111111111111111111011111
11000000121000000000000000000000000000000000000010000000000000000000000000000000000000010010000000000001000000000000001111
11111111121111111111111111111111111111111111111111111111111111111111111111111111000000010001011111111111211111111111121111
11111100121000000000000000000000000000000000000000000000000000000000000000000000000000100010000000000001210000000000000011
11111000121000000000000000000000000000000000000000000000000000000000000000000000000011000100111111111111210011111111111111
11111000121000000000000000000000000000000000000000000000000000000000000000000000000010011000000000000001001000000000000511
11000000121000000000000000000000000000000000000000000000000000000000000000000000000010100111112111111111111111111111111111
11000000121000000000000000000000000000000000000000000000000000000000000000000000000001000000000000000000000000000000001111
11111111121111111111111111111111111111111111111111111111111111111111111111111111111111111111111111111111111111111111111111
11111100121000000000000000000000000000000000000000000000000000000000000000000000000000000000000000000000000000000000000011
11111000000000000000000000000000000000000000000000000000000000000000000000000000000000000000000000000000000000000000000011
11111000000000000000000000000000000000000000000000000000000000000000000000000000000000000000000000000000000000000000000011
11000000000000000000000000000000000000000000000000000000000000000000000000000000000000000000000000000000000000000000000111
11000000000000000000000000000000000000000000000000000000000000000000000000000000000000000000000000000000000000000000001111
111111111111111111111111111111111111111111111111111111111111111111111111111111111111111111111111111111111111111111111111111