NO ./images/N1.xpm
SO ./images/S1.xpm
WE ./images/W1.xpm
EA ./images/E1.xpm   

F 110,110,110

C 41,41,41

     11111111111111
1    1020000011
111111111001111        
10000011121001111
111111111211000111
110E022220010111
110011111100011111
11111011011002011
1111111111111111
