NO ./images/greystone.xpm
SO ./images/wood.xpm
WE ./images/colorstone.xpm
EA ./images/mossy.xpm   

F 110,110,110

C 41,41,41

     11111111111111
1     20000011
111111111001111        
10000011121001111
111100111211000111
110N000100010111
110001020000011111
11110011011000111
1111111111111111
