NO ./images/N1.xpm
SO ./images/S1.xpm
WE ./images/W1.xpm
EA ./images/E1.xpm    
F 110,110,110

C 41,41,41

          1111111111111111111111111111
       1111111022022002202220000000011111
      1111110001121100111111N00000111111111
   111111111100012100022222201100000000001111111
   11111111111111211111111111111111000111111111111111
  11111100000000000000011111111110000022222222222005
   1111111111111110111111       111101111111111111111
    11111111111110000111111111111110000111
      11111111000000000000000000000001111
             1111111111111111111111111
