NO ./images/greystone.xpm
SO ./images/wood.xpm
WE ./images/colorstone.xpm
EA ./images/mossy.xpm   
F 110,110,110

C 41,41,41

          1111111111111111111111111
       11111110000000000000000000011111
      11111100000000010101010000001111111   1
   111111111100000000000000E00000000000111
   111111111111110011111111111111110111111
  11111100000000000000011111111110000111111
   1111111111111110111111       1111011111
    1111111111111000011111111111110000111
      1111111100000000000000000000000111
 1           1111111111111111111111111
