NO ./images/N1.xpm
SO ./images/S1.xpm
WE ./images/W1.xpm
EA ./images/E1.xpm    
F 110,110,110

C 41,41,41

          1111111111111111111111111111
       1111111S22022002202220000000011111
      1111110001121100111111000000111111111
   111111111100012100022222201100000000001111111
   11111111111111211111111110111111000111111111111111
  111110000000000000000111111111100000222222222220051
   1111111111111110111111      1111121111111111111111
    1111111111111100011111111111111121111
      11111111000000000000000000000001111
          11111111111111111111111111111
			 1111111111111111111111111
