NO ./images/N1.xpm
SO ./images/S1.xpm
WE ./images/W1.xpm
EA ./images/E1.xpm    

F 110,110,110

C 41,41,41

         1111111111111111111111111111111111111
       111111100000002222222000000000000000011111
      111111000000000111111N000000111111111111   1
   111111111100000000000000E00000000000111
   111111111111110011111111111111110111111
  11111100000000000000011111111110000111111
   1111111111111110111111       1111011111
    1111111111111000011111111111110000111
      1111111100000000000000000000000111
 1           1111111111111111111111111
